Modificações de personagem
Ganhe vida, um colete e mais $250 milhões em dinheiro: HESOYAM
Armas 1: LXGIWYL
Armas 2: KJKSZPJ
Armas 3: Armas UZUMYMW
Nível máximo de proficiência para todas as armas: NCSGDAG
Munição infinita: WANRLTW
Músculos máximos: JYSDSOD
Respeito máximo: OGXSDAG
Apelo sexual máximo: EHIBXQS
Gordura máxima: BTCDBCB
Personagem magro: KVGYZQK
Super pulo: LFGMHAL
Mega soco: IAVENJQ
Atrair mulheres: BEKKNQV
Modo adrenalina: MUNASEF
Vida infinita: BAGUVIX
Oxigênio infinito: CVWKXAM
Nunca mais sinta fome: AEDUWNV
Recrute alguém equipado com uma pistola: SJMAHPE
Recrute alguém equipado com um lançador de foguetes: ZSOXFSQ
Direção perfeita: PGGOMOY
Nunca será procurado: AEZAKMI
Reseta o nível de procurado: ASNAEB
Aumenta o nível de procurado em 2: OSRBLHH
Aumenta o nível de procurado em 6: LJSPQK
Mata o personagem: SZCMAWO
Todos os NPCs começam a persegui-lo: BAGOWPG

Surgimento de veículos
Monster: AGBDLCID
Rhino: AIWPRTON
Quad: AKJJYGLC
Tank: AMOMHRER
Romero: AQTBCODX
Bloodring Banger: CQZIJMB
Buldozer: EEGCYXT
Rancher: JQNTDMH
Hydra: JUMPJET
Vortex Hovercraft: KGGGDKP
Stretch: KRIJEBR
Hunter: OHDUDE
Carro de corrida 1: PDNEJOH
Carro de corrida 2: VPJTQWV
Carrinho de golfe: RZHSUEW
Caminhão de lixo: UBHYZHQ
Aeronave: URKQSRK
Jetpack: YECGAA
Paraquedas: AIYPWZQP

Modificações de veículos
Carros voadores: RIPAZHA
Barcos voadores: AFSNMSMW
Carros em gravidade zero: BSXSGGC
Táxis com nitro: VKYPQCF
Todos os veículos possuem nitro: COXEFGU
Todos os carros explodem: CPKTNWT
Permite atirar enquanto dirige: OUIQDMW
Carro invisível: XICWMDe

Mudando o ambiente
Tempo muito ensolarado: ICIKPYH
Tempo ensolarado: AFZLLQLL
Tempo chuvoso: AUIFRVQS
Tempo com neblina: CFVFGMJ
Clima tempestuoso: MGHXYRM
Tempo nublado: ALNSFMZO
Tempestade de areia: CWJXUOC
Todos os veículos são pretos: IOWDLAC
Todos os veículos são rosa: LLQPFBN
Todos os veículos são baratos: BGKGTJH
Veículos de campanha: FVTMNBZ
Veículos de corrida: GUSNHDE
Reduz o tráfego: THGLOJ
Todas as luzes de semáforo ficam verdes: ZEIIVG
Noite: XJVSNAJ
Entardecer: OFVIAC
Modo Funhouse: PRIEBJ
Modo Ninja: AFPHULTL
Acelere o relógio: YSOHNUL
Acelere a passagem do tempo: PPGWJHT
Desacelere a passagem do tempo: LIYOAAY

Modificação de outros personagens
Pedestres em trajes de banho: CIKGCGX
Todos estão armados: FOOOXFT
Pedestres armados com tacos de golfe: AJLOJYQY
Pedestres armados com lança-foguetes: BGLUAWML
Comece uma briga: IOJUFZN
Elvis está em todo lugar: ASBHGRB
Motoristas agressivos: YLTEICZ
Gangues onipresentes: MROEMZH
Controle de gangue de rua: MROEMZH